20 20
#__________________#
____________________
___#_______#_#____##
_____#_______#_#___#
_______####I___#____
_____________#__#_##
___#____#__#________
___#______________#_
___#_#_#_##_____#__#
_______#____###____#
__#_____________#___
_________#__________
__#_#_#_____#___##_#
______#____________#
__#_____________#___
______##_#__#___###_
___##____#________##
____________#_______
___#_#____#_#______#
#__#___#__#_#__###F#

