10 10
#________#
F_________
___#_____#
___##_#___
______#___
___#____#_
___#__#___
________##
__________
##_###I###

