20 20
#__________________#
____________________
_____#I#_####_##_#_#
__#_________#_______
__#_________#_#____#
__#_#__#__#____##__#
__#_#______#____#__#
_______#___#_#_F____
___#_____#_#______##
____####_#___##_#___
_________________##_
__________#_______##
___##__##_____#_____
____________#_#___#_
_______#_##___#_#__#
__#_________#_#_____
___#______#___#_#_#_
_____####_#_____#_##
__________#_____#__#
####___##__##_#_##_#

