10 10
#________#
_________#
_________#
___#__#___
___##___#F
_____#__#_
__#______#
_____##___
___#_____#
#___I#_#_#

