10 10
#_______I#
__________
__________
___###_#_#
_______#__
__________
________#_
____###__#
_______#__
###F##_###

