20 20
#__________________#
___________________#
____#__#_#_#_______#
_______________#_#__
__#___##____________
__##_____#__#___#_#_
___##________#__#_##
_____#__##_#_#_____#
__#__#___#_#_#__#___
___________#__#__##_
__#_#___#___________
____##___#__#____#_#
__________#__#______
___##_#_#_____#__#__
____________#____#__
______________#___##
_____#____###_#_#___
___#_#_##________##_
___#_____###___#___#
#F_##_______##__##I#

