20 20
#F_________________#
____________________
__#____#__###_###_##
___#_#_##__________#
________#____#______
____##__#____#______
_________#___#____#_
____#_#__#______#_##
__#___#_____________
________#__###____##
__#_____##_____#___#
_____#___#__##___#_#
__#_______#____#___#
____###___#__#__#__#
______#_________##_#
______##_#_#________
___#___#______#____#
____##____#_#___##__
_______#_____#____#_
###_#__#_##__####I##

