10 10
#________#
_________#
__#___#__#
____#_##_#
__#_______
__#______#
__##___#__
_______#__
__##___#__
#F_#_#I###

