20 20
#__________________#
___________________#
____#_##______#____#
_______##___#___#__#
_____#______#_______
___#_#___#__#__##__#
______##_##F#___#__#
__#___________#_#__#
______#_____#_#____#
______#_______#_#___
____#__#____#____###
__#____#_#__##_____#
____#______________I
________#___________
__#_##____####_##___
________#____#__####
________##____#_____
____##____________##
_____#__#_#________#
###__##___#__#####_#

