10 10
#________#
__________
____##_##F
__________
____#_##_#
__#_#____#
______#__#
___#__#__#
______#___
#I###_####

